3333333333333333333333333333333333333333333
3030000030003000000000000000000000000000003
3030333030303033333330333330333333333333303
3000303030300030300030300030300030000000303
3333303030333330303033303030303030333033303
3000003030000000303000003030303000303000003
3033303030333333303333333030333330303333333
3000300030300000300030000030000030303000003
3330333333303330333030333333333030303033303
3030000000303030300030000000300030300030303
3033333330303030303333333330303330303330303
3000003030003000300000300000003030300000303
3030303033333033333330333333333030333333303
3030300000300030000030300000300030000000303
3030333333303330333030303330303033333330303
3030000000303000300030303000303000300030303
3033333330303033303330303033303030303330303
3030003000303000303000003000303030003000303
3030303033303330303333303330303033303033303
3000303000300000300000300030303030003030003
3333303330333333333330333330303030333030333
3000000030000000300000300000303030300030003
3033333033333030303333303333303033303330303
3030003000300030303000003030003030003000303
3030303330303330303033333030333030333330303
3030300030303030303030300000303030300030303
3030333033303030303030303333303030303033303
3030303000003000300030303000003030303030003
3030303333333033333330303033303030303030333
3030300000003030000000303030003030003030003
3030333330333030303333303033333033333033303
3030003000300030300000003030000030000030003
3333303033303330333333333030333330333330303
3000003000003000300000000030000000300000303
3033333033333033333030333333333333303333303
3000003000003030003030000000000030003030003
3333303333303030303333333033303033303030333
3000003000303000300000003000303000003000303
3033303030333333333333303330303333333033303
3030003030300000000000300030303000003000003
3033333030303330333333333033303033333333303
3000000030000030000000000000003000000000003
3333333333333333333333333333333333333333333
